00000000000000000000
00000000000000000000
00000444000000000000
00000344000000000000
00000443000000000000
00044343400000000000
00040400400000000000
04440400400000442200
04344344444444442200
00000400040100442200
00000444440000000000
00000000000000000000
00000000000000000000
00000000000000000000
00000000000000000000
00000000000000000000
00000000000000000000
00000000000000000000
00000000000000000000
00000000000000000000
