00000000000000000000
00000000000000000000
00000000000000000000
00000000000000000000
00000422400000000000
00000444400000000000
00000040000000000000
00000010000000000000
00000030000000000000
00000040000000000000
00044440000000000000
00040344000000000000
00044404000000000000
00000444000000000000
00000000000000000000
00000000000000000000
00000000000000000000
00000000000000000000
00000000000000000000
00000000000000000000
